R 240 800
NO tests/textures/grass.xpm
SO tests/textures/brownstone.xpm
WE tests/textures/grass.xpm
EA tests/textures/whitestone.xpm
S tests/textures/sprite/barrel.xpm

F 220,100,0
C 225,30,0

1111111111111111111111111
1000000000110000000000001
101100000111000200W000001
100100000000000000000000111111111
111111111011000001110000000000001
100000000011000001110111111111111
11110111111111011100000010001
11110111111111011101010010201
11000000110101011100000000001
10002000000000001100000010001
10000000000000001101010010001
11000001110101011101011110001
11110111111101011101111000001
11111111111111111111111111111
