R  1920 1080
NO ./path_to_the_north_texture
SO ./path_to_the_south_texture
WE ./path_to_the_west_texture
EA ./path_to_the_east_texture
S ./path_to_the_sprite_texture

F 220,100,6
C 225,30,4

11111111111
12001010001
1001N100001
10001020001
11111111111