R			1920 1080
NO ./textures/fuhrer.xpm
SO ./textures/bluestone.xpm		
EA ./textures/mossy.xpm
WE ./textures/colorstone.xpm
S ./textures/barrel.xpm
		F 220,849,6
C 225,30,4

111111111111
100000000002111111111111
100000S00002000000000021
122222222221111111111111
111111111111


11111
10001
10001
11111
