R  724 328
NO ./path_to_the_north_texture
SO ./path_to_the_south_texture
WE ./path_to_the_west_texture
EA ./path_to_the_east_texture
S ./path_to_the_sprite_texture

F 220,100,6
C 225,30,4

11111111111
10000000001
1000020S001
10000200001
11111111111