R 1044 920
             SO ./textures/fuhrer.xpm				 	
NO ./textures/bluestone.xpm	 	 	 	 	 	
 	 	EA  	 	 	 	./textures/mossy.xpm 	 	
  WE 	 		 ./textures/colorstone.xpm	  		 
S  		 ./textures/barrel.xpm 		 
      F     0,3,3
C 1,250,25


1111111111111
11111000000001111111111111
1000000W000200000000001
100000000001111111111111
111111111111


11111
10001
10001
11111