R 1044 920
			 SO ./textures/fuhrer.xpm				 	
NO ./textures/bluestone.xpm	 	 	 	 	 	
 	 	EA  	 	 	 	./textures/mossy.xpm 	 	
  WE 	 		 ./textures/colorstone.xpm	  		 
S  		 ./textures/barrel.xpm 		 
	  F        	   23,240,230               
 C 50,50,50       

11111111
1N000001
11111111