R  1920 1080
NO ./textures/fuhrer.xpm
SO ./textures/bluestone.xpm		
WE ./textures/colorstone.xpm
EA ./textures/mossy.xpm
S ./textures/barrel.xpm
F 220,100,6
C 225,30,4

1111111111111
100000000002111111111111
100000W00000000020000011
100000000001111111111111
1111111111111